1111111111
10C1000C01
1010000011
1P0C11E001
1111111111
