1111111111
10C1000C01
1010000011
1P0C11E001
1101C10101
1001010001
1011000001
1000001111
1111111111
